NO ./path_to_north_texture
SO ./path_to_south_texture
WE ./path_to_west_texture
EA ./path_to_east_texture
F 255,255,255
C 154, 255,255

11111111111
100000000011111111
100000000000000001
100000000011111111
11110000001
   10000001
   10000001
11110000001
10000000001
10000E00001
10000000001
11111111111
