NO ./path_to_north_texture
SO ./path_to_south_texture
WE ./path_to_west_texture
EA ./path_to_north_texture

F 255,255,255
C 0,0,0

11111111111111     111111
10000000000001     100001
10000000000001     100001
10000000000001     100001
11110000000001     100001
   10000000001     100001
   10000000001     100001
11110000000001     100001
10000000000001     100001
100000N0000001     100001
10000000000001     100001
11111111111111     111111
